1111111111111
1001P000001C1
1000011110001
1C00110000101
111110C100101
1000000001E01
1111111111111