1111111
10000E1
1000001
1000001
1P00001
1111111
