1111111
10000P1
10000E1
1000001
1000001
1111111
